111111
1P0C01
1000C1
1000E1
111111