11111111111111111111111111111
1E00010111000000000C100101111
1111C1000C00001111C1000C00001
1111C0000C00001111C1000C00001
1100C111C100111100C111C100111
1C0111111110001C0111111110001
1001C0C00C10001001C0C00C10001
10C1000000000C10C0000000000C1
11111111100111111111111001111
10000101110000100001011100001
111101000C00001111C1000C00001
11000001010011110000010100111
110001110100111100C111C100111
100111111110001C0111111110001
100100000010001001C0C00C10001
1001000000000P10C100000000001
11111111111111111111111111111