111111111111111111111111111111
1C000000000000C01C1000100000E1
100111111111001110000010000001
1000000C000000000000001C011111
100111111111001011000000000001
100000000001001001000000000001
100000000001001001111110011111
1111110010C10010C1000010010C01
1C00000011110011110C0010010001
100001001000000001000010011011
11111100100000C001100110000001
1P00000C10C0000001000000000001
111111111111111111111111111111