111111111111111111111111111111
1E0001011100000000011000000001
1111C1000C000011100110C0010001
110000010100111110000C00010C01
1100C111C100110111111111011111
1C01111111100001C000100001C001
1001C0C00C100001000010C0010001
10C1000000000P01000000010000C1
111111111111111111111111111111